ように言われた;	To tell about an interdiction or prohibition, direction or advice;	先生に宿題ぞ忘れないように注意された;
く/じゃ＋なさそうだった;	When you guess something is not "" based on an observation or feeling;	この仕事はそんなに大変じゃなさそうだ;
Verb + と;	When you notice something you hadn't noticed before;	持ち合わせの場所に着くと、友達はもう来ていた;
- ほど ~;	Describe the degree or unusual condition of ~by giving the example of -;	双子は両親もまちがえるほどよく似ている;
なら;	nara is at the end of the condition before making a suggestion on that condition;	台湾へ旅行に行くなら、１１月が一番いいと思います;
って/という;the name of	;	;
verb + させて + もらう/くれる;	Obtain the permission from someone to do something;	ここに荷物を置かせてもらってもいいですか;
verb + させられた;	When someone else tells you to do something;	子供のときテストの成績が悪いと、父にトイレ掃除をさせられた;
verb + た(い) + がる;	When a person's feelings are shown through their manner or speech;	寒い日は猫も外へ出たがらない;
verb + たとたん;	When you do something just after the verb;	立ち上がったとたん、目の前が暗くなった;
verb + 出す;	When something happens suddenly;	彼は短気で急に怒り出すから、付き合いにくい;
動詞 + ようとする;	When you do your best to do something. When you critisizes someone for not doing something;	生まれたばかりの馬の赤ちゃんが、一生懸命立とうとしている;
どうし + こともある;	When you have occasionally do something;	あの店の営業時間は５時までですが、昼過ぎに全部うれてしまうこともあります;
どうし + せておいて;	When someone has been instructed to keep doing a task;	夏に車の中で子供を待たせておくのは危険ですよ;
どうし + られてしまう;	When you an action by another person in unfortunate;	片思いの彼を映画に誘ったが、断られてしまった;
N + による;	Express the means or method by which it's done;	経営学理論の講義は試験を行わず、リポートによる評価を行う;
N + 対して + action;	Express a direct action toward the subject or reaction;	私費留学生に対する奨学金などの援助はまだ十分ではないと思う;
N + につき;	Express a condition linked to an action (ex time につき price);	当スポーツクラブ会員以外でも、１回につき２０００円で施設をご利用いただけます;
N + を通して;	when instead of doing an action directly it has been carried by someone else or some other mean;	私は海外留学を通じて多くのことを学んだ;
によると/ によれば;According to;;
ということです;I hear that(Used to express hearsay);	;
Action + っけ;	When you speculate about something you don't have clear memory or forgot;	クリーニング屋、何時までだっけ;
PI + たりして;	Perhaps or Maybe;	芸能人だったりして;
たって;でも	;	悲しくたって、寂しくたって、絶対泣かない;
に決まってる;	When you wanna stress that you are absolutely sure;	あのチームは今年も最下位に決まってるよ;
じゃない;	n'est ce pas;	歌下手だって言ってたけど、上手じゃない;
(なけれ)ばよっかた / ならよっかた;	when you have regrets on the result of an action you didn't act on;	このかばん、機内持ち込みだめだって。もうちょっとちさければよっかたんだけど;
N + V-て + ばかり;	when you are criticizing of only doing or doing too much of the action;	ゲームばかりしていると、目が悪くなります;
A は B ほど~ない;	A is not ~ as B;	和菓子はケーキほどカロリーが高くないと思って、つい食べ過ぎてしまう;
ずに;ないで	;	宛先のアドレスをよく確認せずに送信してしまあう;
まま;	when a situation stays in the same way / or if something that must be done about the current situation isn't;	久しぶりに帰ったふるさとは以前のままだった;
~ところへー;	when you express that ー happened in a particular time setting ~;	最後の問題が解けたところで、試験終了のキャイム賀鳴ったんだ;
V + きって;	When action is done to the end or when an action is too long to be completed;	この目薬は２週間で使いきってください。残ったら使わないで捨ててください;
durée/periode + を通して;	To say that something happened throughout that period;	弟は中学の３年間を通して、無遅刻、無欠席だった;
~というと/といえば/といったら;	When you say something that people often associate with ~.;	冬のスポーツといったら、やっぱりスキーだよね;
~べきです;	When you say that something is the natural/correct thing to do;	慣れない人は雪道で車の運転をするべきではないと思う;
ばかりでなく　も;	not only;	落語は最近、お年寄りばかりでなく若い女性にも人気が出てきた;
Action + たびに;	When something happens everytime you take an action;	父は出張のたびにお土産を買ってきてくれる;
はずです;	When you have a good reason for doing something;	１：来週接待を頼まれちゃって、トルコからのお客様なんだけど ２：じゃ、田中さんに手伝ってもらったらどう？トルコに留学していたから色々知っているはずだよ;
ようなら;polite たら;	;
V - て + くる;	When something not present until now appears or begins;	朝から降っていた雨がやんで、ちょっと晴れてきた;
ものですから;	When you're justifiying, the current situation;	余計な一言を言ってしまったものだから、取引先の部長を怒らせてしまった;
N＋なんか;	When you're suggesting an option but leave the choice to the listener;	１：運動したいと思うんですけど、なかなか ２：誰にでも簡単にできて、楽しめるスポーツもありますよ。ボウリングなんかいいんじゃないですか;
うちに;	When a change came naturally along the way of an other action;	調査を集めるうちにその企業の問題点が明らかなった;
Vた＋ばかり;	When (you feel that) almost no time has passed since the action;	父は昨日退院したばかりなのに、今日から会社に出ている;
いいのに;	When you're showing disappointment in an action or you urge them politely to change their behavior;	このかばん、高すぎるよ。半額ならいいのになあ;
すでに;	Already;	;
によって/N + による + N;	when a situation differs depending on someone or place or time;	;
最中;	when something happens suddenly while you're doing something;	;
V + かけ;	when you have started something and aren't finished with it yet;	;
V + ずにはいられなく;	when you can't help yourself and end up doing something no matter how hard you tried not to;	;
せめて;	at least;	;
わけがない;	strongly deny something because it is unthinkable;	;
しかない;	there is no other way it can't be helped;	;
からこそ;	emphasize one argument;	;
なんか;	when you wanna downplay the importance of something;	;
っこない;there is no chance / no way;	;
からといって;	just because _ won't;	;
とは限らない;	when the general impression doesn't always apply;	;
ことといったら;	when you to express a strong impression such as surprise or anger;	;
くせに;	when you have a bad impression of someone;	;
せいです;	when you state the reason for a bad result;	;
気味;	to express your current state;	;
っぽなし;	to express that the action is not good to continue;	;
だらけ;	when something is filled with filth or mistakes;	;
たりして;	when you gently that someone is different than usual;	;
らしく;	when a characteristic stands out;	;
なんか　ない;	to emphasize that something is not true;	;
かと思った;	when you mistake someone;	;
のついで;	when you take advantage of an action do to something else;	;
ぬぎで;	when an usual is not there;	;
